TILEMAP
12 24							-- Size of tile map in tiles
40 40							-- Tile size & block size
images/blocks.png 	-- Tilesheet
4 8								-- Number of tiles in tilesheet
EEEEEEEEEEEE
G          F
G          F
G          F
G          F
GA  AAA  AAF
G   A A A  F
G          F
G    BB    F
G  BBB     F
GAA  C   AAF
G          F
G          F
G          F
G          F
G          F
G          F
G          F
G          F
G          F
G          F
G          F
G          F
EEEE    EEEE

