TILEMAP
12 24							-- Size of tile map in tiles
40 40							-- Tile size & block size
images/blocks.png 	-- Tilesheet
4 8								-- Number of tiles in tilesheet
EEEEEEEEEEEE
G         AF
G         BF
G         CF
G         DF
GA  AAA  AAF
G   A A A BF
G         CF
G    BB   DF
G  BBB    AF
GAA  C   ABF
G         CF
G         DF
G         AF
G         BF
G         CF
G         DF
G         AF
G         BF
G         CF
G         DF
G         AF
G         BF
EEEE    EEEE

